#%..#&..#.b
=[-]=[--=]b
=%#.=&..=.b
=[=]=[--=.b
=.=.=&#.=.b
=%=.=[=--]b
=[-]=&=.#.b
=%..=[=-=]b
=[-]=.=.=.b
=...=.=.=.b
[--------]b
..........b
rgggrgggrrr